"filename", "language", "Python", "CSV", "YAML", "comment", "blank", "total"
"d:\miniProjects\discuzCrawler\discuz-crawler\src\SaveVOTest.py", "Python", 5, 0, 0, 0, 5, 10
"d:\miniProjects\discuzCrawler\discuz-crawler\src\__init__.py", "Python", 0, 0, 0, 0, 1, 1
"d:\miniProjects\discuzCrawler\discuz-crawler\src\browser\Browser.py", "Python", 51, 0, 0, 58, 16, 125
"d:\miniProjects\discuzCrawler\discuz-crawler\src\browser\__init__.py", "Python", 0, 0, 0, 0, 1, 1
"d:\miniProjects\discuzCrawler\discuz-crawler\src\browser\controller\ImageSaveController.py", "Python", 11, 0, 0, 10, 7, 28
"d:\miniProjects\discuzCrawler\discuz-crawler\src\browser\controller\ScrollController.py", "Python", 7, 0, 0, 4, 5, 16
"d:\miniProjects\discuzCrawler\discuz-crawler\src\browser\controller\SliderController.py", "Python", 30, 0, 0, 10, 8, 48
"d:\miniProjects\discuzCrawler\discuz-crawler\src\browser\controller\__init__.py", "Python", 0, 0, 0, 0, 1, 1
"d:\miniProjects\discuzCrawler\discuz-crawler\src\browser\webdriverinitializer\ChromeWebDriverInitializer.py", "Python", 11, 0, 0, 5, 4, 20
"d:\miniProjects\discuzCrawler\discuz-crawler\src\browser\webdriverinitializer\EdgeWebDriverInitializer.py", "Python", 9, 0, 0, 5, 5, 19
"d:\miniProjects\discuzCrawler\discuz-crawler\src\browser\webdriverinitializer\__init__.py", "Python", 0, 0, 0, 0, 1, 1
"d:\miniProjects\discuzCrawler\discuz-crawler\src\data\status.csv", "CSV", 0, 102, 0, 0, 103, 205
"d:\miniProjects\discuzCrawler\discuz-crawler\src\enums\CommentResponse.py", "Python", 7, 0, 0, 0, 3, 10
"d:\miniProjects\discuzCrawler\discuz-crawler\src\exceptions\CommentIllegalRequestError.py", "Python", 6, 0, 0, 0, 5, 11
"d:\miniProjects\discuzCrawler\discuz-crawler\src\exceptions\CommentIntervalLimitError.py", "Python", 6, 0, 0, 0, 5, 11
"d:\miniProjects\discuzCrawler\discuz-crawler\src\exceptions\CommentPerHourLimitError.py", "Python", 6, 0, 0, 0, 5, 11
"d:\miniProjects\discuzCrawler\discuz-crawler\src\exceptions\CommentPublishError.py", "Python", 5, 0, 0, 0, 3, 8
"d:\miniProjects\discuzCrawler\discuz-crawler\src\exceptions\DataIsEmptyError.py", "Python", 5, 0, 0, 0, 3, 8
"d:\miniProjects\discuzCrawler\discuz-crawler\src\exceptions\SlideError.py", "Python", 5, 0, 0, 0, 3, 8
"d:\miniProjects\discuzCrawler\discuz-crawler\src\exceptions\SlideRobotDetectedError.py", "Python", 6, 0, 0, 0, 5, 11
"d:\miniProjects\discuzCrawler\discuz-crawler\src\exceptions\SlideToWrongPositionError.py", "Python", 6, 0, 0, 0, 5, 11
"d:\miniProjects\discuzCrawler\discuz-crawler\src\exceptions\StatusDetectError.py", "Python", 5, 0, 0, 0, 3, 8
"d:\miniProjects\discuzCrawler\discuz-crawler\src\exceptions\VONotFoundError.py", "Python", 5, 0, 0, 0, 3, 8
"d:\miniProjects\discuzCrawler\discuz-crawler\src\main.py", "Python", 52, 0, 0, 0, 9, 61
"d:\miniProjects\discuzCrawler\discuz-crawler\src\module\CommentPublisher.py", "Python", 98, 0, 0, 1, 16, 115
"d:\miniProjects\discuzCrawler\discuz-crawler\src\module\FeiMaoDiskTransferor.py", "Python", 49, 0, 0, 0, 13, 62
"d:\miniProjects\discuzCrawler\discuz-crawler\src\module\PostStatusDetector.py", "Python", 54, 0, 0, 0, 11, 65
"d:\miniProjects\discuzCrawler\discuz-crawler\src\resource\config.yml", "YAML", 0, 0, 15, 0, 0, 15
"d:\miniProjects\discuzCrawler\discuz-crawler\src\utils\AsyncRequest.py", "Python", 40, 0, 0, 10, 12, 62
"d:\miniProjects\discuzCrawler\discuz-crawler\src\utils\Banner.py", "Python", 21, 0, 0, 0, 7, 28
"d:\miniProjects\discuzCrawler\discuz-crawler\src\utils\ConfigLoader.py", "Python", 27, 0, 0, 0, 15, 42
"d:\miniProjects\discuzCrawler\discuz-crawler\src\utils\CookieUtil.py", "Python", 17, 0, 0, 8, 5, 30
"d:\miniProjects\discuzCrawler\discuz-crawler\src\utils\DataStore.py", "Python", 60, 0, 0, 9, 10, 79
"d:\miniProjects\discuzCrawler\discuz-crawler\src\utils\Logging.py", "Python", 42, 0, 0, 0, 13, 55
"d:\miniProjects\discuzCrawler\discuz-crawler\src\utils\PageParser.py", "Python", 68, 0, 0, 0, 17, 85
"d:\miniProjects\discuzCrawler\discuz-crawler\src\utils\SliderUtil.py", "Python", 48, 0, 0, 28, 9, 85
"d:\miniProjects\discuzCrawler\discuz-crawler\src\utils\SyncRequest.py", "Python", 38, 0, 0, 10, 12, 60
"d:\miniProjects\discuzCrawler\discuz-crawler\src\utils\__init__.py", "Python", 0, 0, 0, 0, 1, 1
"d:\miniProjects\discuzCrawler\discuz-crawler\src\vo\PostStatus.py", "Python", 13, 0, 0, 0, 3, 16
"d:\miniProjects\discuzCrawler\discuz-crawler\src\vo\__init__.py", "Python", 0, 0, 0, 0, 1, 1
"Total", "-", 813, 102, 15, 158, 354, 1442